|
|
|                     t        e
|                   ========#======
|                           #
|                           #
|  e    t   ----------------#
++=+++==++++==              #
                            #
ttt-------           t      #  e
===      #          ========#======
         #                  #
   t     #     -------      #
===#===========             #
   #                        #
   #               ======   #
   #            p  ======   #
   #               ==tt==   #
   #               =========#======
   #   ==                   #
   #   ==   t               #
===================================