|                     t
|                   ========#==
|       t   ________________#
============                #
                            #
                     t      #
                    ========#======
      t        _______      #
===#===========             #
   #                 t      #
   #               ======   #
   #                        #
   #        t               #
===================================